//MAP CONVERTED BY dmm2tgm.py THIS HEADER COMMENT PREVENTS RECONVERSION, DO NOT REMOVE
"a" = (
/turf/closed/mineral/titanium,
/area/ruin/space/has_grav/powered)
"c" = (
/turf/closed/mineral/uranium,
/area/ruin/space/has_grav/powered)
"d" = (
/obj/effect/turf_decal/stripes/line{
	dir = 6
	},
/turf/open/floor/circuit/green/anim,
/area/ruin/space/has_grav/powered)
"e" = (
/obj/effect/turf_decal/stripes/line{
	dir = 4
	},
/turf/open/floor/circuit/green/anim,
/area/ruin/space/has_grav/powered)
"i" = (
/obj/effect/turf_decal/stripes/line{
	dir = 10
	},
/turf/open/floor/circuit/green/anim,
/area/ruin/space/has_grav/powered)
"l" = (
/mob/living/simple_animal/hostile/megafauna/rogueprocess,
/turf/open/floor/mech_bay_recharge_floor,
/area/ruin/space/has_grav/powered)
"p" = (
/obj/effect/turf_decal/stripes/corner{
	dir = 8
	},
/turf/open/floor/circuit/green/anim,
/area/ruin/space/has_grav/powered)
"q" = (
/obj/effect/turf_decal/caution/stand_clear/red{
	dir = 1
	},
/obj/machinery/door/firedoor/closed,
/turf/open/floor/circuit/green/anim,
/area/ruin/space/has_grav/powered)
"t" = (
/obj/effect/turf_decal/stripes/corner,
/turf/open/floor/circuit/green/anim,
/area/ruin/space/has_grav/powered)
"x" = (
/obj/effect/turf_decal/stripes/line,
/turf/open/floor/circuit/green/anim,
/area/ruin/space/has_grav/powered)
"C" = (
/obj/effect/turf_decal/stripes/line{
	dir = 5
	},
/turf/open/floor/circuit/green/anim,
/area/ruin/space/has_grav/powered)
"H" = (
/obj/effect/turf_decal/stripes/line{
	dir = 1
	},
/turf/open/floor/circuit/green/anim,
/area/ruin/space/has_grav/powered)
"I" = (
/obj/effect/turf_decal/caution/stand_clear/red{
	dir = 4
	},
/obj/machinery/door/firedoor/closed,
/turf/open/floor/circuit/green/anim,
/area/ruin/space/has_grav/powered)
"M" = (
/obj/effect/turf_decal/caution/stand_clear/red{
	dir = 8
	},
/obj/machinery/door/firedoor/closed,
/turf/open/floor/circuit/green/anim,
/area/ruin/space/has_grav/powered)
"P" = (
/obj/effect/turf_decal/stripes/line{
	dir = 8
	},
/turf/open/floor/circuit/green/anim,
/area/ruin/space/has_grav/powered)
"R" = (
/obj/effect/turf_decal/stripes/corner{
	dir = 4
	},
/turf/open/floor/circuit/green/anim,
/area/ruin/space/has_grav/powered)
"S" = (
/obj/effect/turf_decal/stripes/corner{
	dir = 1
	},
/turf/open/floor/circuit/green/anim,
/area/ruin/space/has_grav/powered)
"T" = (
/turf/open/lava/smooth/lava_land_surface,
/area/ruin/space/has_grav/powered)
"U" = (
/obj/effect/turf_decal/stripes/line{
	dir = 9
	},
/turf/open/floor/circuit/green/anim,
/area/ruin/space/has_grav/powered)
"W" = (
/obj/effect/turf_decal/caution/stand_clear/red,
/obj/machinery/door/firedoor/closed,
/turf/open/floor/circuit/green/anim,
/area/ruin/space/has_grav/powered)
"X" = (
/turf/open/floor/circuit/green/anim,
/area/ruin/space/has_grav/powered)

(1,1,1) = {"
a
a
a
a
a
a
a
a
a
a
a
a
a
a
a
a
a
a
a
a
a
a
a
"}
(2,1,1) = {"
a
c
c
c
c
T
T
T
T
T
T
M
T
T
T
T
T
T
c
c
c
c
a
"}
(3,1,1) = {"
a
c
c
T
T
T
T
X
X
X
x
X
H
X
X
X
T
T
T
T
c
c
a
"}
(4,1,1) = {"
a
c
T
T
T
X
X
X
X
X
x
X
H
X
X
X
X
X
T
T
T
c
a
"}
(5,1,1) = {"
a
c
T
T
X
X
X
X
X
X
x
X
H
X
X
X
X
X
X
T
T
c
a
"}
(6,1,1) = {"
a
T
T
X
X
X
X
X
X
X
x
X
H
X
X
X
X
X
X
X
T
T
a
"}
(7,1,1) = {"
a
T
T
X
X
X
X
X
X
X
x
X
H
X
X
X
X
X
X
X
T
T
a
"}
(8,1,1) = {"
a
T
X
X
X
X
X
X
X
X
x
X
H
X
X
X
X
X
X
X
X
T
a
"}
(9,1,1) = {"
a
T
X
X
X
X
X
X
X
X
x
X
H
X
X
X
X
X
X
X
X
T
a
"}
(10,1,1) = {"
a
T
X
X
X
X
X
X
X
t
d
X
C
p
X
X
X
X
X
X
X
T
a
"}
(11,1,1) = {"
a
T
e
e
e
e
e
e
e
d
t
e
p
C
e
e
e
e
e
e
e
T
a
"}
(12,1,1) = {"
a
q
X
X
X
X
X
X
X
X
x
l
H
X
X
X
X
X
X
X
X
W
a
"}
(13,1,1) = {"
a
T
P
P
P
P
P
P
P
i
S
P
R
U
P
P
P
P
P
P
P
T
a
"}
(14,1,1) = {"
a
T
X
X
X
X
X
X
X
S
i
X
U
R
X
X
X
X
X
X
X
T
a
"}
(15,1,1) = {"
a
T
X
X
X
X
X
X
X
X
x
X
H
X
X
X
X
X
X
X
X
T
a
"}
(16,1,1) = {"
a
T
X
X
X
X
X
X
X
X
x
X
H
X
X
X
X
X
X
X
X
T
a
"}
(17,1,1) = {"
a
T
T
X
X
X
X
X
X
X
x
X
H
X
X
X
X
X
X
X
T
T
a
"}
(18,1,1) = {"
a
T
T
X
X
X
X
X
X
X
x
X
H
X
X
X
X
X
X
X
T
T
a
"}
(19,1,1) = {"
a
c
T
T
X
X
X
X
X
X
x
X
H
X
X
X
X
X
X
T
T
c
a
"}
(20,1,1) = {"
a
c
T
T
T
X
X
X
X
X
x
X
H
X
X
X
X
X
T
T
T
c
a
"}
(21,1,1) = {"
a
c
c
T
T
T
T
X
X
X
x
X
H
X
X
X
T
T
T
T
c
c
a
"}
(22,1,1) = {"
a
c
c
c
c
T
T
T
T
T
T
I
T
T
T
T
T
T
c
c
c
c
a
"}
(23,1,1) = {"
a
a
a
a
a
a
a
a
a
a
a
a
a
a
a
a
a
a
a
a
a
a
a
"}
